I'm A Believer - Smash Mouth
Let's Twist Again - Chubby Checker
Lonely Boy - The Black Keys
One Way Or Another - Blondie
Runnin' Down A Dream - Tom Petty
Sydney (I'll Come Running) - Brett Dennen
The Middle - Jimmy Eat World
The River - Good Charlotte
Tightrope [Big Boi Vocal Edit] (part. Big Boi) - Janelle Mon√°e
What I Like About You - The Romantics
I Can Talk - Two Door Cinema Club
Maniac - Michael Sembello
Runaway Baby - Bruno Mars
La Grange (2005 Remaster) - ZZ Top
Tightrope - WALK THE MOON
Ca plane pour moi - Plastic Bertrand
This Head I Hold - Electric Guest
The Man - The Motorhomes
Take a Chance - The Magic Numbers
From a Window Seat - Dawes
Salute Your Solution - The Raconteurs
I'm Shakin' - Jack White
Take On Me - A-ha
Devour - Shinedown
Go With The Flow - Queens Of The Stone Age
Monkey Wrench - Foo Fighters
Young Turks - Rod Stewart
Too Much Time Together - San Cisco
Lesson No. 7 - Clock Opera
Bang Bang - Ariana Grande, Nicki Minaj e Jessie J
Undercover Martyn - Two Door Cinema Club
Hum Hallelujah - Fall Out Boy
Never Stop (part. Ollie Wride) - FM-84
End of the World - Armor For Sleep
Everyday I Love You Less and Less - Kaiser Chiefs
Lovin' Machine (from the Hootenanny 2009) - Jools Holland & Paolo Nutini
Fluctuate - Catfish and the Bottlemen
Danger Zone - Kenny Loggins
Hard To Explain - The Strokes
I'm Free (Heaven Helps the Man) (From "Footloose" Soundtrack) - Kenny Loggins
December - Neck Deep
Get What I Need - Goldfinger
Some Suck Some Rock (part. [spunge]) - [spunge]
Time For You To Go - Sum 41